datetime,prefecture,pop_male,pop_female,pop_sum,pop_households
2000-01-01,北海道,2726996,2955831,5682827,2409748
2000-01-01,青森県,719503,780222,1499725,533622
2000-01-01,岩手県,689575,735560,1425135,476527
2000-01-01,宮城県,1149560,1194292,2343852,820971
2000-01-01,秋田県,574332,629139,1203471,401028
2000-01-01,山形県,602709,642246,1244955,377170
2000-01-01,福島県,1043430,1092914,2136344,691438
2000-01-01,茨城県,1498343,1495529,2993872,994283
2000-01-01,栃木県,994851,1005646,2000497,667731
2000-01-01,群馬県,997987,1019781,2017768,686418
2000-01-01,埼玉県,3473605,3396398,6870003,2494032
2000-01-01,千葉県,2970072,2923094,5893166,2202096
2000-01-01,東京都,5850975,5892214,11743189,5410701
2000-01-01,神奈川県,4254083,4116209,8370292,3367173
2000-01-01,新潟県,1207399,1274987,2482386,783615
2000-01-01,富山県,543483,582536,1126019,354190
2000-01-01,石川県,569110,606551,1175661,400095
2000-01-01,福井県,401923,426266,828189,252810
2000-01-01,山梨県,435760,449662,885422,306705
2000-01-01,長野県,1076876,1125441,2202317,745221
2000-01-01,岐阜県,1027611,1081536,2109147,672234
2000-01-01,静岡県,1854312,1905178,3759490,1281912
2000-01-01,愛知県,3457537,3449442,6906979,2489443
2000-01-01,三重県,903453,953923,1857376,642217
2000-01-01,滋賀県,653645,671973,1325618,429956
2000-01-01,京都府,1241846,1321509,2563355,1003072
2000-01-01,大阪府,4237819,4388947,8626766,3490552
2000-01-01,兵庫県,2678372,2843054,5521426,2081509
2000-01-01,奈良県,698990,750156,1449146,505105
2000-01-01,和歌山県,520614,570646,1091260,398730
2000-01-01,鳥取県,295966,321859,617825,207962
2000-01-01,島根県,365127,398572,763699,260159
2000-01-01,岡山県,944447,1013217,1957664,704896
2000-01-01,広島県,1393292,1481023,2874315,1122814
2000-01-01,山口県,727270,807165,1534435,603619
2000-01-01,徳島県,398844,434564,833408,295137
2000-01-01,香川県,498551,536003,1034554,375751
2000-01-01,愛媛県,717402,794453,1511855,582904
2000-01-01,高知県,386919,432333,819252,332432
2000-01-01,福岡県,2370302,2597384,4967686,1922863
2000-01-01,佐賀県,419909,463602,883511,284506
2000-01-01,長崎県,723124,809111,1532235,574155
2000-01-01,熊本県,885819,984000,1869819,664172
2000-01-01,大分県,585511,650897,1236408,463631
2000-01-01,宮崎県,563067,623964,1187031,457458
2000-01-01,鹿児島県,840746,946375,1787121,736210
2000-01-01,沖縄県,654766,670068,1324834,460932
2001-01-01,北海道,2719862,2955447,5675309,2436803
2001-01-01,青森県,717802,779234,1497036,538269
2001-01-01,岩手県,688014,733782,1421796,479898
2001-01-01,宮城県,1150114,1197052,2347166,830137
2001-01-01,秋田県,571313,626253,1197566,403765
2001-01-01,山形県,600835,640529,1241364,380216
2001-01-01,福島県,1042154,1091242,2133396,697883
2001-01-01,茨城県,1498592,1496991,2995583,1005916
2001-01-01,栃木県,996280,1007003,2003283,676522
2001-01-01,群馬県,998774,1020952,2019726,694974
2001-01-01,埼玉県,3486548,3411671,6898219,2533096
2001-01-01,千葉県,2982470,2937928,5920398,2237604
2001-01-01,東京都,5887300,5931545,11818845,5499594
2001-01-01,神奈川県,4278479,4147304,8425783,3423758
2001-01-01,新潟県,1204445,1272455,2476900,790262
2001-01-01,富山県,542973,581441,1124414,357780
2001-01-01,石川県,568833,607768,1176601,404542
2001-01-01,福井県,401854,426185,828039,254986
2001-01-01,山梨県,436302,449775,886077,310247
2001-01-01,長野県,1078463,1126035,2204498,754206
2001-01-01,岐阜県,1027856,1081948,2109804,679490
2001-01-01,静岡県,1856656,1907398,3764054,1297993
2001-01-01,愛知県,3469761,3465270,6935031,2522862
2001-01-01,三重県,904198,954692,1858890,649763
2001-01-01,滋賀県,658014,676607,1334621,438151
2001-01-01,京都府,1240456,1322749,2563205,1013278
2001-01-01,大阪府,4233511,4395090,8628601,3530048
2001-01-01,兵庫県,2682757,2854608,5537365,2109673
2001-01-01,奈良県,698130,750403,1448533,510934
2001-01-01,和歌山県,518630,568984,1087614,401715
2001-01-01,鳥取県,295601,321477,617078,210111
2001-01-01,島根県,364408,397736,762144,262338
2001-01-01,岡山県,943951,1013578,1957529,710991
2001-01-01,広島県,1391660,1480536,2872196,1131362
2001-01-01,山口県,724379,804565,1528944,607854
2001-01-01,徳島県,397724,433517,831241,297503
2001-01-01,香川県,497966,535282,1033248,379249
2001-01-01,愛媛県,715605,793237,1508842,588114
2001-01-01,高知県,386439,431430,817869,335476
2001-01-01,福岡県,2374096,2605131,4979227,1947757
2001-01-01,佐賀県,419520,463119,882639,286990
2001-01-01,長崎県,720384,807014,1527398,578499
2001-01-01,熊本県,886135,984281,1870416,671518
2001-01-01,大分県,584463,649966,1234429,467977
2001-01-01,宮崎県,561345,623190,1184535,461840
2001-01-01,鹿児島県,838763,944468,1783231,742526
2001-01-01,沖縄県,659184,674938,1334122,470781
2002-01-01,北海道,2713662,2953362,5667024,2464894
2002-01-01,青森県,715331,777338,1492669,543009
2002-01-01,岩手県,684905,731516,1416421,482542
2002-01-01,宮城県,1149498,1198967,2348465,839484
2002-01-01,秋田県,567159,622848,1190007,406347
2002-01-01,山形県,598292,638686,1236978,382927
2002-01-01,福島県,1039231,1089078,2128309,704171
2002-01-01,茨城県,1497753,1497631,2995384,1017583
2002-01-01,栃木県,996572,1007829,2004401,684669
2002-01-01,群馬県,999337,1021901,2021238,703010
2002-01-01,埼玉県,3499679,3426835,6926514,2576437
2002-01-01,千葉県,2996504,2954080,5950584,2277249
2002-01-01,東京都,5928897,5976815,11905712,5597805
2002-01-01,神奈川県,4305343,4179401,8484744,3486305
2002-01-01,新潟県,1200911,1269730,2470641,796825
2002-01-01,富山県,541820,580739,1122559,361145
2002-01-01,石川県,568063,608375,1176438,408676
2002-01-01,福井県,401287,426056,827343,256913
2002-01-01,山梨県,435582,449614,885196,313041
2002-01-01,長野県,1077758,1125442,2203200,761702
2002-01-01,岐阜県,1027831,1081182,2109013,687089
2002-01-01,静岡県,1857941,1908818,3766759,1314562
2002-01-01,愛知県,3484455,3480328,6964783,2559770
2002-01-01,三重県,903906,954214,1858120,657473
2002-01-01,滋賀県,661072,680333,1341405,445556
2002-01-01,京都府,1239179,1324165,2563344,1024463
2002-01-01,大阪府,4232750,4403467,8636217,3574895
2002-01-01,兵庫県,2686069,2864350,5550419,2137659
2002-01-01,奈良県,695889,749619,1445508,515811
2002-01-01,和歌山県,516340,567051,1083391,404897
2002-01-01,鳥取県,295452,321190,616642,212529
2002-01-01,島根県,362924,396379,759303,263808
2002-01-01,岡山県,943592,1013636,1957228,717452
2002-01-01,広島県,1389392,1479619,2869011,1140136
2002-01-01,山口県,721131,801565,1522696,611689
2002-01-01,徳島県,396753,432432,829185,300064
2002-01-01,香川県,496945,534525,1031470,382602
2002-01-01,愛媛県,713710,791337,1505047,593489
2002-01-01,高知県,385608,430446,816054,338237
2002-01-01,福岡県,2377894,2612600,4990494,1972564
2002-01-01,佐賀県,418405,462260,880665,289372
2002-01-01,長崎県,717470,804670,1522140,582875
2002-01-01,熊本県,885443,983632,1869075,678399
2002-01-01,大分県,582781,648752,1231533,471746
2002-01-01,宮崎県,559992,622070,1182062,466257
2002-01-01,鹿児島県,837195,942962,1780157,748869
2002-01-01,沖縄県,663602,679522,1343124,480792
2003-01-01,北海道,2709851,2953005,5662856,2496182
2003-01-01,青森県,712593,774858,1487451,547986
2003-01-01,岩手県,681844,729332,1411176,485466
2003-01-01,宮城県,1148981,1201151,2350132,848185
2003-01-01,秋田県,562929,619096,1182025,408430
2003-01-01,山形県,595976,636602,1232578,385731
2003-01-01,福島県,1036167,1086446,2122613,710409
2003-01-01,茨城県,1496635,1497111,2993746,1029068
2003-01-01,栃木県,997348,1008119,2005467,693066
2003-01-01,群馬県,999994,1022672,2022666,711305
2003-01-01,埼玉県,3512939,3441337,6954276,2618360
2003-01-01,千葉県,3007770,2970517,5978287,2314450
2003-01-01,東京都,5970143,6026317,11996460,5692903
2003-01-01,神奈川県,4332855,4214002,8546857,3548584
2003-01-01,新潟県,1196888,1266852,2463740,803703
2003-01-01,富山県,540953,579890,1120843,364625
2003-01-01,石川県,567794,608306,1176100,413137
2003-01-01,福井県,401092,425308,826400,259075
2003-01-01,山梨県,434873,449297,884170,316304
2003-01-01,長野県,1077267,1125466,2202733,769904
2003-01-01,岐阜県,1028177,1081008,2109185,694599
2003-01-01,静岡県,1859716,1910060,3769776,1331253
2003-01-01,愛知県,3501584,3496443,6998027,2598433
2003-01-01,三重県,904046,954068,1858114,665056
2003-01-01,滋賀県,664171,684070,1348241,453074
2003-01-01,京都府,1238084,1325689,2563773,1036184
2003-01-01,大阪府,4231157,4412520,8643677,3616094
2003-01-01,兵庫県,2688908,2872314,5561222,2164036
2003-01-01,奈良県,693500,748471,1441971,520383
2003-01-01,和歌山県,514075,564980,1079055,408330
2003-01-01,鳥取県,295019,320793,615812,214843
2003-01-01,島根県,361747,395023,756770,265893
2003-01-01,岡山県,943324,1013989,1957313,724832
2003-01-01,広島県,1390048,1480494,2870542,1151261
2003-01-01,山口県,718946,799008,1517954,616278
2003-01-01,徳島県,395796,431290,827086,302931
2003-01-01,香川県,496913,534272,1031185,386420
2003-01-01,愛媛県,712780,789716,1502496,599575
2003-01-01,高知県,384295,428942,813237,340259
2003-01-01,福岡県,2382027,2619565,5001592,1998460
2003-01-01,佐賀県,417515,461282,878797,291597
2003-01-01,長崎県,715043,801877,1516920,587014
2003-01-01,熊本県,883969,982584,1866553,684616
2003-01-01,大分県,581851,647808,1229659,475887
2003-01-01,宮崎県,558844,621139,1179983,471266
2003-01-01,鹿児島県,835072,940564,1775636,754556
2003-01-01,沖縄県,668790,684422,1353212,490788
2004-01-01,北海道,2701143,2949430,5650573,2522295
2004-01-01,青森県,707870,771488,1479358,551806
2004-01-01,岩手県,678479,726581,1405060,488354
2004-01-01,宮城県,1147848,1202178,2350026,856527
2004-01-01,秋田県,558386,615336,1173722,410308
2004-01-01,山形県,592192,633798,1225990,387732
2004-01-01,福島県,1032608,1083602,2116210,716505
2004-01-01,茨城県,1495404,1496400,2991804,1039865
2004-01-01,栃木県,997986,1008731,2006717,701919
2004-01-01,群馬県,999865,1022915,2022780,719576
2004-01-01,埼玉県,3525294,3455595,6980889,2660152
2004-01-01,千葉県,3016885,2984147,6001032,2348339
2004-01-01,東京都,6009113,6073030,12082143,5776805
2004-01-01,神奈川県,4355073,4245036,8600109,3602950
2004-01-01,新潟県,1192961,1263035,2455996,810483
2004-01-01,富山県,539805,578856,1118661,367754
2004-01-01,石川県,567181,607890,1175071,417164
2004-01-01,福井県,400155,424669,824824,260744
2004-01-01,山梨県,433943,448735,882678,319146
2004-01-01,長野県,1075953,1124943,2200896,777553
2004-01-01,岐阜県,1027060,1079857,2106917,701408
2004-01-01,静岡県,1861708,1911432,3773140,1347330
2004-01-01,愛知県,3515928,3511571,7027499,2634915
2004-01-01,三重県,903688,954085,1857773,672654
2004-01-01,滋賀県,666501,687392,1353893,460199
2004-01-01,京都府,1238089,1327335,2565424,1048788
2004-01-01,大阪府,4230586,4421391,8651977,3657248
2004-01-01,兵庫県,2688548,2878018,5566566,2187130
2004-01-01,奈良県,691763,747277,1439040,525535
2004-01-01,和歌山県,511038,562396,1073434,411063
2004-01-01,鳥取県,294537,320113,614650,216963
2004-01-01,島根県,359589,392945,752534,267189
2004-01-01,岡山県,943513,1013756,1957269,732253
2004-01-01,広島県,1389212,1480343,2869555,1161859
2004-01-01,山口県,716177,796156,1512333,620630
2004-01-01,徳島県,393861,429443,823304,305362
2004-01-01,香川県,495991,533365,1029356,389901
2004-01-01,愛媛県,710128,786801,1496929,603933
2004-01-01,高知県,382442,427112,809554,341873
2004-01-01,福岡県,2385375,2625484,5010859,2023115
2004-01-01,佐賀県,416405,460635,877040,293751
2004-01-01,長崎県,712011,799053,1511064,591017
2004-01-01,熊本県,881795,981100,1862895,690743
2004-01-01,大分県,580694,646413,1227107,480113
2004-01-01,宮崎県,557372,620083,1177455,475947
2004-01-01,鹿児島県,832358,937574,1769932,759742
2004-01-01,沖縄県,672825,689303,1362128,501093
2005-01-01,北海道,2688938,2943195,5632133,5653027
2005-01-01,青森県,701710,766898,1468608,1472631
2005-01-01,岩手県,673774,722863,1396637,1397139
2005-01-01,宮城県,1145558,1202412,2347970,2351898
2005-01-01,秋田県,553269,611120,1164389,1166634
2005-01-01,山形県,588539,630336,1218875,1220865
2005-01-01,福島県,1028079,1079721,2107800,2110337
2005-01-01,茨城県,1493694,1495035,2988729,2992660
2005-01-01,栃木県,999068,1008968,2008036,2010710
2005-01-01,群馬県,998641,1022093,2020734,2022460
2005-01-01,埼玉県,3531323,3465205,6996528,7002824
2005-01-01,千葉県,3021369,2993215,6014584,6023696
2005-01-01,東京都,6047471,6120776,12168247,12183509
2005-01-01,神奈川県,4372897,4271134,8644031,8652841
2005-01-01,新潟県,1187449,1258358,2445807,2449888
2005-01-01,富山県,538757,577630,1116387,1117688
2005-01-01,石川県,565267,606866,1172133,1173849
2005-01-01,福井県,398946,423459,822405,823652
2005-01-01,山梨県,433064,447883,880947,881966
2005-01-01,長野県,1071790,1121629,2193419,2196828
2005-01-01,岐阜県,1026636,1079657,2106293,2109006
2005-01-01,静岡県,1862300,1911526,3773826,3776552
2005-01-01,愛知県,3535146,3527616,7062762,7072191
2005-01-01,三重県,904443,953583,1858026,1859896
2005-01-01,滋賀県,669133,690140,1359273,1360552
2005-01-01,京都府,1236917,1328253,2565170,2567874
2005-01-01,大阪府,4224272,4427029,8651301,8659435
2005-01-01,兵庫県,2688226,2882922,5571148,5577609
2005-01-01,奈良県,688853,745695,1434548,1435622
2005-01-01,和歌山県,507599,559515,1067114,1068415
2005-01-01,鳥取県,293262,318929,612191,613601
2005-01-01,島根県,356730,390739,747469,749700
2005-01-01,岡山県,942513,1012804,1955317,1957964
2005-01-01,広島県,1388159,1480092,2868251,2872530
2005-01-01,山口県,712739,792178,1504917,1506771
2005-01-01,徳島県,391534,427464,818998,820476
2005-01-01,香川県,495072,532333,1027405,1029007
2005-01-01,愛媛県,706778,784053,1490831,1494170
2005-01-01,高知県,379794,424927,804721,805621
2005-01-01,福岡県,2384726,2629453,5014179,5023093
2005-01-01,佐賀県,414717,459261,873978,875659
2005-01-01,長崎県,707001,795057,1502058,1506100
2005-01-01,熊本県,879052,978946,1857998,1862710
2005-01-01,大分県,580123,644769,1224892,1225364
2005-01-01,宮崎県,554961,617979,1172940,1176159
2005-01-01,鹿児島県,828732,934272,1763004,1771591
2005-01-01,沖縄県,677637,694751,1372388,1375760
2006-01-01,北海道,2685621,2944349,5629970,2580577
2006-01-01,青森県,697087,763057,1460144,559992
2006-01-01,岩手県,669048,719116,1388164,494553
2006-01-01,宮城県,1142742,1201827,2344569,873867
2006-01-01,秋田県,549091,607265,1156356,415268
2006-01-01,山形県,584990,627173,1212163,392726
2006-01-01,福島県,1024439,1076412,2100851,729712
2006-01-01,茨城県,1493593,1494940,2988533,1066417
2006-01-01,栃木県,1000048,1009450,2009498,721820
2006-01-01,群馬県,998401,1021636,2020037,737189
2006-01-01,埼玉県,3541321,3478598,7019919,2740244
2006-01-01,千葉県,3030365,3005293,6035658,2415289
2006-01-01,東京都,6098401,6174975,12273376,5965301
2006-01-01,神奈川県,4394049,4299324,8693373,3713460
2006-01-01,新潟県,1183816,1254666,2438482,824873
2006-01-01,富山県,538254,576460,1114714,376396
2006-01-01,石川県,564777,606329,1171106,427341
2006-01-01,福井県,398306,422767,821073,265138
2006-01-01,山梨県,432474,446765,879239,325265
2006-01-01,長野県,1070432,1120442,2190874,792352
2006-01-01,岐阜県,1025807,1079204,2105011,717915
2006-01-01,静岡県,1863993,1911910,3775903,1381349
2006-01-01,愛知県,3560668,3545917,7106585,2727161
2006-01-01,三重県,904792,952664,1857456,691279
2006-01-01,滋賀県,672580,692813,1365393,478096
2006-01-01,京都府,1237313,1329107,2566420,1073798
2006-01-01,大阪府,4226519,4437200,8663719,3737692
2006-01-01,兵庫県,2689148,2887636,5576784,2241030
2006-01-01,奈良県,686240,744126,1430366,535928
2006-01-01,和歌山県,504878,556681,1061559,417375
2006-01-01,鳥取県,292361,318073,610434,221162
2006-01-01,島根県,355392,389285,744677,271033
2006-01-01,岡山県,942876,1012043,1954919,750127
2006-01-01,広島県,1389895,1481012,2870907,1187580
2006-01-01,山口県,709842,789160,1499002,629841
2006-01-01,徳島県,390364,425957,816321,311575
2006-01-01,香川県,494399,531689,1026088,397801
2006-01-01,愛媛県,705084,781862,1486946,614046
2006-01-01,高知県,376792,422329,799121,345184
2006-01-01,福岡県,2390818,2637208,5028026,2078133
2006-01-01,佐賀県,413819,458483,872302,300048
2006-01-01,長崎県,703152,791727,1494879,599335
2006-01-01,熊本県,878889,979633,1858522,706000
2006-01-01,大分県,578569,643145,1221714,490431
2006-01-01,宮崎県,554890,617512,1172402,485582
2006-01-01,鹿児島県,827244,932406,1759650,771145
2006-01-01,沖縄県,681652,700168,1381820,523579
2007-01-01,北海道,2667157,2933548,5600705,2599764
2007-01-01,青森県,688786,756806,1445592,562919
2007-01-01,岩手県,663141,714525,1377666,497023
2007-01-01,宮城県,1139577,1200908,2340485,883414
2007-01-01,秋田県,542444,601385,1143829,415863
2007-01-01,山形県,580612,623487,1204099,394212
2007-01-01,福島県,1018443,1070996,2089439,736288
2007-01-01,茨城県,1492374,1493741,2986115,1079882
2007-01-01,栃木県,998539,1007824,2006363,730557
2007-01-01,群馬県,996396,1019840,2016236,745233
2007-01-01,埼玉県,3551162,3490882,7042044,2781143
2007-01-01,千葉県,3040351,3017897,6058248,2454027
2007-01-01,東京都,6140844,6220892,12361736,6060432
2007-01-01,神奈川県,4414659,4326366,8741025,3774373
2007-01-01,新潟県,1176946,1248737,2425683,831390
2007-01-01,富山県,536357,574356,1110713,379768
2007-01-01,石川県,563751,605498,1169249,431925
2007-01-01,福井県,397094,421349,818443,266948
2007-01-01,山梨県,430551,445070,875621,328309
2007-01-01,長野県,1067363,1117233,2184596,798841
2007-01-01,岐阜県,1023525,1076888,2100413,724887
2007-01-01,静岡県,1864019,1911348,3775367,1397457
2007-01-01,愛知県,3583458,3562156,7145614,2774999
2007-01-01,三重県,905510,951580,1857090,701695
2007-01-01,滋賀県,676235,695342,1371577,487389
2007-01-01,京都府,1234403,1327879,2562282,1085362
2007-01-01,大阪府,4221515,4443590,8665105,3779054
2007-01-01,兵庫県,2689479,2891018,5580497,2267661
2007-01-01,奈良県,682922,742386,1425308,540542
2007-01-01,和歌山県,500659,553237,1053896,420679
2007-01-01,鳥取県,290439,316256,606695,222832
2007-01-01,島根県,352535,386545,739080,272241
2007-01-01,岡山県,941360,1010060,1951420,758762
2007-01-01,広島県,1388148,1479275,2867423,1198083
2007-01-01,山口県,704620,784556,1489176,633395
2007-01-01,徳島県,388013,423665,811678,314289
2007-01-01,香川県,492829,530245,1023074,401497
2007-01-01,愛媛県,701138,778637,1479775,618521
2007-01-01,高知県,373248,419171,792419,346228
2007-01-01,福岡県,2390173,2640138,5030311,2104652
2007-01-01,佐賀県,411962,456600,868562,302591
2007-01-01,長崎県,696224,785922,1482146,601788
2007-01-01,熊本県,875155,976918,1852073,712952
2007-01-01,大分県,576586,641480,1218066,495120
2007-01-01,宮崎県,552278,615231,1167509,489832
2007-01-01,鹿児島県,822798,928712,1751510,775541
2007-01-01,沖縄県,683782,703736,1387518,532688
2008-01-01,北海道,2648735,2923035,5571770,2618005
2008-01-01,青森県,680654,749889,1430543,565347
2008-01-01,岩手県,657304,709348,1366652,499351
2008-01-01,宮城県,1135696,1199178,2334874,891573
2008-01-01,秋田県,535577,595246,1130823,416787
2008-01-01,山形県,575514,618557,1194071,395308
2008-01-01,福島県,1011125,1064430,2075555,740993
2008-01-01,茨城県,1490148,1491852,2982000,1093512
2008-01-01,栃木県,999536,1007165,2006701,740354
2008-01-01,群馬県,994315,1017836,2012151,752614
2008-01-01,埼玉県,3563014,3504322,7067336,2827608
2008-01-01,千葉県,3056110,3034689,6090799,2498476
2008-01-01,東京都,6189004,6273192,12462196,6160440
2008-01-01,神奈川県,4441495,4356794,8798289,3832776
2008-01-01,新潟県,1170645,1242458,2413103,837457
2008-01-01,富山県,534180,572160,1106340,382789
2008-01-01,石川県,562527,604624,1167151,435912
2008-01-01,福井県,395584,419760,815344,269072
2008-01-01,山梨県,428199,443282,871481,330911
2008-01-01,長野県,1063273,1113533,2176806,804784
2008-01-01,岐阜県,1021355,1074129,2095484,732298
2008-01-01,静岡県,1864834,1910566,3775400,1413428
2008-01-01,愛知県,3606324,3579420,7185744,2822885
2008-01-01,三重県,905823,950459,1856282,710875
2008-01-01,滋賀県,679613,698273,1377886,496305
2008-01-01,京都府,1231740,1326802,2558542,1096291
2008-01-01,大阪府,4219619,4450683,8670302,3821714
2008-01-01,兵庫県,2688918,2893312,5582230,2293683
2008-01-01,奈良県,679530,740096,1419626,545391
2008-01-01,和歌山県,496361,549612,1045973,423263
2008-01-01,鳥取県,288127,314284,602411,224026
2008-01-01,島根県,349588,383535,733123,273450
2008-01-01,岡山県,939835,1008415,1948250,766961
2008-01-01,広島県,1386655,1477512,2864167,1209084
2008-01-01,山口県,700205,779635,1479840,637020
2008-01-01,徳島県,384948,421003,805951,316542
2008-01-01,香川県,491071,528262,1019333,404585
2008-01-01,愛媛県,696678,774832,1471510,622441
2008-01-01,高知県,368799,415239,784038,347102
2008-01-01,福岡県,2388578,2642240,5030818,2129522
2008-01-01,佐賀県,409857,454881,864738,305260
2008-01-01,長崎県,689356,779841,1469197,606559
2008-01-01,熊本県,871415,973229,1844644,718259
2008-01-01,大分県,575691,639697,1215388,500649
2008-01-01,宮崎県,548674,612352,1161026,493192
2008-01-01,鹿児島県,816260,922815,1739075,778579
2008-01-01,沖縄県,684806,706409,1391215,541444
2009-01-01,北海道,2631725,2911831,5543556,2637145
2009-01-01,青森県,673523,743755,1417278,567780
2009-01-01,岩手県,651160,704045,1355205,500973
2009-01-01,宮城県,1132994,1197904,2330898,899364
2009-01-01,秋田県,529279,589456,1118735,417941
2009-01-01,山形県,570832,614268,1185100,396212
2009-01-01,福島県,1005142,1058627,2063769,745762
2009-01-01,茨城県,1489299,1490340,2979639,1107164
2009-01-01,栃木県,998197,1005757,2003954,747665
2009-01-01,群馬県,992378,1016464,2008842,759967
2009-01-01,埼玉県,3576123,3520146,7096269,2870345
2009-01-01,千葉県,3073000,3051453,6124453,2540337
2009-01-01,東京都,6230681,6317577,12548258,6241989
2009-01-01,神奈川県,4462962,4385367,8848329,3887348
2009-01-01,新潟県,1165103,1236700,2401803,843516
2009-01-01,富山県,531887,569750,1101637,385637
2009-01-01,石川県,561519,603494,1165013,440424
2009-01-01,福井県,394276,418168,812444,270459
2009-01-01,山梨県,425777,441345,867122,333259
2009-01-01,長野県,1059179,1109747,2168926,809650
2009-01-01,岐阜県,1018127,1071286,2089413,738663
2009-01-01,静岡県,1864242,1909452,3773694,1428465
2009-01-01,愛知県,3623538,3594812,7218350,2862859
2009-01-01,三重県,904910,949140,1854050,718960
2009-01-01,滋賀県,681484,700837,1382321,503523
2009-01-01,京都府,1229651,1325999,2555650,1106903
2009-01-01,大阪府,4219995,4456627,8676622,3864118
2009-01-01,兵庫県,2689793,2896461,5586254,2321121
2009-01-01,奈良県,676434,738536,1414970,550523
2009-01-01,和歌山県,492683,546046,1038729,425943
2009-01-01,鳥取県,286230,312255,598485,225096
2009-01-01,島根県,347189,380604,727793,274839
2009-01-01,岡山県,937658,1006206,1943864,774399
2009-01-01,広島県,1383862,1475438,2859300,1217486
2009-01-01,山口県,696373,775342,1471715,640299
2009-01-01,徳島県,382551,418274,800825,317907
2009-01-01,香川県,489640,526900,1016540,407972
2009-01-01,愛媛県,693151,771156,1464307,626663
2009-01-01,高知県,365141,411939,777080,347669
2009-01-01,福岡県,2387702,2644168,5031870,2147845
2009-01-01,佐賀県,408430,453726,862156,307581
2009-01-01,長崎県,684219,774185,1458404,607465
2009-01-01,熊本県,868797,970512,1839309,724636
2009-01-01,大分県,573799,637243,1211042,504579
2009-01-01,宮崎県,545852,609992,1155844,496743
2009-01-01,鹿児島県,811139,917415,1728554,782188
2009-01-01,沖縄県,687889,709923,1397812,550420
2010-01-01,北海道,2618969,2901925,5520894,2654310
2010-01-01,青森県,667377,738158,1405535,571091
2010-01-01,岩手県,645922,699085,1345007,503139
2010-01-01,宮城県,1132240,1197104,2329344,906925
2010-01-01,秋田県,523940,584297,1108237,419270
2010-01-01,山形県,566781,609978,1176759,397683
2010-01-01,福島県,998942,1052684,2051626,749760
2010-01-01,茨城県,1489569,1489570,2979139,1121039
2010-01-01,栃木県,996502,1004272,2000774,753759
2010-01-01,群馬県,990601,1014185,2004786,766784
2010-01-01,埼玉県,3588368,3534716,7123084,2910960
2010-01-01,千葉県,3084888,3064911,6149799,2573718
2010-01-01,東京都,6255821,6354091,12609912,6296239
2010-01-01,神奈川県,4476728,4408730,8885458,3928288
2010-01-01,新潟県,1160033,1231058,2391091,849247
2010-01-01,富山県,529963,567773,1097736,388425
2010-01-01,石川県,560522,602428,1162950,444565
2010-01-01,福井県,392782,416683,809465,272292
2010-01-01,山梨県,424339,439871,864210,335689
2010-01-01,長野県,1055513,1106059,2161572,814404
2010-01-01,岐阜県,1014995,1068123,2083118,745569
2010-01-01,静岡県,1862426,1907259,3769685,1440680
2010-01-01,愛知県,3632381,3605231,7237612,2891553
2010-01-01,三重県,902510,947193,1849703,724893
2010-01-01,滋賀県,683318,703252,1386570,510070
2010-01-01,京都府,1227484,1324222,2551706,1116543
2010-01-01,大阪府,4221854,4461181,8683035,3901462
2010-01-01,兵庫県,2688838,2897344,5586182,2345254
2010-01-01,奈良県,674564,737151,1411715,555909
2010-01-01,和歌山県,489718,543061,1032779,428389
2010-01-01,鳥取県,284641,310690,595331,226434
2010-01-01,島根県,345066,378116,723182,276298
2010-01-01,岡山県,935420,1004029,1939449,780663
2010-01-01,広島県,1382471,1473837,2856308,1226633
2010-01-01,山口県,692736,771539,1464275,643004
2010-01-01,徳島県,379192,417705,796897,320344
2010-01-01,香川県,487577,525178,1012755,410801
2010-01-01,愛媛県,689999,767951,1457950,630260
2010-01-01,高知県,363212,409189,772401,349612
2010-01-01,福岡県,2391310,2647264,5038574,2175227
2010-01-01,佐賀県,407174,452226,859400,309659
2010-01-01,長崎県,680387,769640,1450027,611343
2010-01-01,熊本県,865885,967872,1833757,729603
2010-01-01,大分県,571782,635194,1206976,508207
2010-01-01,宮崎県,544397,608117,1152514,500694
2010-01-01,鹿児島県,808913,913492,1722405,786259
2010-01-01,沖縄県,692385,713791,1406176,559851
2011-01-01,北海道,2606676,2892240,5498916,2670572
2011-01-01,青森県,662430,733456,1395886,574712
2011-01-01,岩手県,641096,693718,1334814,505347
2011-01-01,宮城県,1127216,1191740,2318956,912225
2011-01-01,秋田県,518609,578979,1097588,420351
2011-01-01,山形県,562996,605756,1168752,399045
2011-01-01,福島県,991824,1044322,2036146,752754
2011-01-01,茨城県,1486528,1486646,2973174,1132370
2011-01-01,栃木県,994133,1001768,1995901,760385
2011-01-01,群馬県,987671,1010887,1998558,772913
2011-01-01,埼玉県,3594851,3546078,7140929,2944273
2011-01-01,千葉県,3089444,3072477,6161921,2599887
2011-01-01,東京都,6275193,6387268,12662461,6344540
2011-01-01,神奈川県,4481050,4425540,8906590,3962170
2011-01-01,新潟県,1153973,1224880,2378853,854420
2011-01-01,富山県,527854,565031,1092885,391022
2011-01-01,石川県,559359,600847,1160206,448539
2011-01-01,福井県,391457,414971,806428,274156
2011-01-01,山梨県,422626,437933,860559,338154
2011-01-01,長野県,1051779,1102023,2153802,819637
2011-01-01,岐阜県,1012043,1064632,2076675,751299
2011-01-01,静岡県,1857844,1902957,3760801,1451812
2011-01-01,愛知県,3636521,3613105,7249626,2918116
2011-01-01,三重県,899926,944367,1844293,730515
2011-01-01,滋賀県,685552,705375,1390927,517676
2011-01-01,京都府,1224789,1322436,2547225,1125013
2011-01-01,大阪府,4218182,4463441,8681623,3932806
2011-01-01,兵庫県,2684529,2895610,5580139,2364110
2011-01-01,奈良県,671702,734999,1406701,560521
2011-01-01,和歌山県,486125,539488,1025613,430260
2011-01-01,鳥取県,283326,308887,592213,227848
2011-01-01,島根県,342801,375417,718218,277672
2011-01-01,岡山県,932602,1001455,1934057,786906
2011-01-01,広島県,1380736,1471992,2852728,1232636
2011-01-01,山口県,688770,766631,1455401,645165
2011-01-01,徳島県,376501,414741,791242,321753
2011-01-01,香川県,486413,523381,1009794,413948
2011-01-01,愛媛県,686303,763959,1450262,633350
2011-01-01,高知県,360489,405937,766426,350151
2011-01-01,福岡県,2393825,2649669,5043494,2198679
2011-01-01,佐賀県,405516,450452,855968,312104
2011-01-01,長崎県,676042,764811,1440853,613611
2011-01-01,熊本県,863695,964776,1828471,735976
2011-01-01,大分県,569465,632436,1201901,511536
2011-01-01,宮崎県,542091,605776,1147867,504234
2011-01-01,鹿児島県,805361,908623,1713984,789406
2011-01-01,沖縄県,696260,717323,1413583,568860
2012-01-01,北海道,2592061,2882155,5474216,2685761
2012-01-01,青森県,655598,727445,1383043,577351
2012-01-01,岩手県,632865,684930,1317795,506306
2012-01-01,宮城県,1120196,1182510,2302706,918304
2012-01-01,秋田県,512618,573400,1086018,421338
2012-01-01,山形県,558711,601493,1160204,401201
2012-01-01,福島県,971512,1020353,1991865,747619
2012-01-01,茨城県,1480363,1479647,2960010,1142271
2012-01-01,栃木県,990800,997955,1988755,766343
2012-01-01,群馬県,984009,1006935,1990944,778481
2012-01-01,埼玉県,3595889,3553614,7149503,2978999
2012-01-01,千葉県,3080284,3067335,6147619,2616794
2012-01-01,東京都,6287628,6411643,12699271,6390020
2012-01-01,神奈川県,4481070,4436298,8917368,3993565
2012-01-01,新潟県,1146879,1217753,2364632,859516
2012-01-01,富山県,525519,562025,1087544,393868
2012-01-01,石川県,557901,598829,1156730,451929
2012-01-01,福井県,390019,413161,803180,275683
2012-01-01,山梨県,419905,435841,855746,339911
2012-01-01,長野県,1048196,1097766,2145962,825012
2012-01-01,岐阜県,1008111,1060831,2068942,757371
2012-01-01,静岡県,1852360,1898211,3750571,1463726
2012-01-01,愛知県,3642308,3620865,7263173,2947483
2012-01-01,三重県,897197,941416,1838613,727521
2012-01-01,滋賀県,687275,707197,1394472,525061
2012-01-01,京都府,1221837,1320903,2542740,1132893
2012-01-01,大阪府,4213507,4466426,8679933,3963932
2012-01-01,兵庫県,2679022,2893383,5572405,2381894
2012-01-01,奈良県,668673,732570,1401243,564867
2012-01-01,和歌山県,482712,535956,1018668,432124
2012-01-01,鳥取県,281563,307152,588715,228484
2012-01-01,島根県,340432,372624,713056,278913
2012-01-01,岡山県,931589,999997,1931586,793664
2012-01-01,広島県,1377499,1469181,2846680,1239126
2012-01-01,山口県,684130,761343,1445473,646582
2012-01-01,徳島県,375762,410878,786640,323849
2012-01-01,香川県,484726,521762,1006488,416706
2012-01-01,愛媛県,681901,759390,1441291,635273
2012-01-01,高知県,357267,402413,759680,350332
2012-01-01,福岡県,2396212,2653245,5049457,2222103
2012-01-01,佐賀県,404291,449072,853363,314652
2012-01-01,長崎県,671779,759706,1431485,616491
2012-01-01,熊本県,860916,961415,1822331,744226
2012-01-01,大分県,567071,629733,1196804,514432
2012-01-01,宮崎県,540141,603603,1143744,507719
2012-01-01,鹿児島県,801968,904113,1706081,792803
2012-01-01,沖縄県,700593,722345,1422938,578976
2013-01-01,北海道,2583864,2881587,5465451,2709610
2013-01-01,青森県,649775,722235,1372010,581393
2013-01-01,岩手県,630345,683835,1314180,512115
2013-01-01,宮城県,1127994,1190698,2318692,937269
2013-01-01,秋田県,507078,569127,1076205,423751
2013-01-01,山形県,554935,601007,1155942,404981
2013-01-01,福島県,964940,1015319,1980259,754115
2013-01-01,茨城県,1498212,1498860,2997072,1177748
2013-01-01,栃木県,999989,1010945,2010934,786704
2013-01-01,群馬県,999089,1024293,2023382,803368
2013-01-01,埼玉県,3648069,3624235,7272304,3057860
2013-01-01,千葉県,3117679,3122776,6240455,2684067
2013-01-01,東京都,6492421,6650219,13142640,6653367
2013-01-01,神奈川県,4551421,4532222,9083643,4092210
2013-01-01,新潟県,1143702,1217431,2361133,869721
2013-01-01,富山県,528469,566358,1094827,403627
2013-01-01,石川県,560864,602225,1163089,462124
2013-01-01,福井県,392503,418049,810552,283611
2013-01-01,山梨県,422833,441084,863917,348271
2013-01-01,長野県,1054823,1110781,2165604,843222
2013-01-01,岐阜県,1021660,1081219,2102879,787440
2013-01-01,静岡県,1879425,1930045,3809470,1509901
2013-01-01,愛知県,3735388,3727412,7462800,3072876
2013-01-01,三重県,912646,958973,1871619,763846
2013-01-01,滋賀県,699514,719912,1419426,543393
2013-01-01,京都府,1241673,1345456,2587129,1168371
2013-01-01,大阪府,4299966,4573732,8873698,4090596
2013-01-01,兵庫県,2719028,2941274,5660302,2448763
2013-01-01,奈良県,669688,735765,1405453,573923
2013-01-01,和歌山県,481158,535405,1016563,436289
2013-01-01,鳥取県,280814,307694,588508,231638
2013-01-01,島根県,340027,373107,713134,282991
2013-01-01,岡山県,937214,1008869,1946083,812189
2013-01-01,広島県,1389017,1484586,2873603,1266881
2013-01-01,山口県,684550,762949,1447499,654718
2013-01-01,徳島県,374083,410918,785001,328671
2013-01-01,香川県,486676,524031,1010707,424532
2013-01-01,愛媛県,681135,758982,1440117,643076
2013-01-01,高知県,355386,400608,755994,351945
2013-01-01,福岡県,2422551,2682876,5105427,2278258
2013-01-01,佐賀県,403752,449589,853341,319367
2013-01-01,長崎県,669336,757797,1427133,622522
2013-01-01,熊本県,861509,963852,1825361,751689
2013-01-01,大分県,568067,631334,1199401,522988
2013-01-01,宮崎県,538729,602830,1141559,512497
2013-01-01,鹿児島県,798787,902600,1701387,797800
2013-01-01,沖縄県,708020,729974,1437994,591269
2014-01-01,北海道,2584535,2878510,5463045,2727383
2014-01-01,青森県,648210,719648,1367858,585217
2014-01-01,岩手県,629528,681839,1311367,515721
2014-01-01,宮城県,1135266,1194173,2329439,950570
2014-01-01,秋田県,504302,565924,1070226,425062
2014-01-01,山形県,553083,598235,1151318,407350
2014-01-01,福島県,964124,1011972,1976096,760145
2014-01-01,茨城県,1496794,1496844,2993638,1187182
2014-01-01,栃木県,1000267,1010005,2010272,793003
2014-01-01,群馬県,997422,1022265,2019687,808409
2014-01-01,埼玉県,3655713,3633135,7288848,3085738
2014-01-01,千葉県,3121248,3126612,6247860,2704016
2014-01-01,東京都,6520890,6681147,13202037,6699648
2014-01-01,神奈川県,4557660,4542946,9100606,4114032
2014-01-01,新潟県,1141402,1213470,2354872,874981
2014-01-01,富山県,527097,564515,1091612,405987
2014-01-01,石川県,561756,601624,1163380,466200
2014-01-01,福井県,391335,416894,808229,284689
2014-01-01,山梨県,421772,439843,861615,350033
2014-01-01,長野県,1052516,1108298,2160814,846447
2014-01-01,岐阜県,1019826,1078350,2098176,792656
2014-01-01,静岡県,1876932,1926549,3803481,1518772
2014-01-01,愛知県,3743655,3734951,7478606,3096802
2014-01-01,三重県,911909,956951,1868860,768510
2014-01-01,滋賀県,700641,721138,1421779,548478
2014-01-01,京都府,1241455,1344449,2585904,1176024
2014-01-01,大阪府,4302152,4576542,8878694,4117692
2014-01-01,兵庫県,2716545,2938816,5655361,2460392
2014-01-01,奈良県,668495,734539,1403034,577501
2014-01-01,和歌山県,479267,532969,1012236,437711
2014-01-01,鳥取県,280295,306772,587067,232676
2014-01-01,島根県,339502,371862,711364,284580
2014-01-01,岡山県,937274,1007934,1945208,817223
2014-01-01,広島県,1391174,1485126,2876300,1273017
2014-01-01,山口県,682990,760156,1443146,656773
2014-01-01,徳島県,372893,409449,782342,329886
2014-01-01,香川県,486601,523427,1010028,427135
2014-01-01,愛媛県,679888,756639,1436527,645431
2014-01-01,高知県,355110,399165,754275,353246
2014-01-01,福岡県,2430718,2688095,5118813,2296175
2014-01-01,佐賀県,403582,448703,852285,321314
2014-01-01,長崎県,668501,756032,1424533,626316
2014-01-01,熊本県,862439,963247,1825686,757073
2014-01-01,大分県,567885,629969,1197854,525691
2014-01-01,宮崎県,539582,602904,1142486,515953
2014-01-01,鹿児島県,800257,902534,1702791,802845
2014-01-01,沖縄県,713684,734674,1448358,600573
2015-01-01,北海道,2568237,2863421,5431658,2738172
2015-01-01,青森県,641035,712301,1353336,586819
2015-01-01,岩手県,624594,676369,1300963,518383
2015-01-01,宮城県,1135024,1193109,2328133,961409
2015-01-01,秋田県,497843,558736,1056579,425771
2015-01-01,山形県,548411,592324,1140735,408771
2015-01-01,福島県,960877,1004509,1965386,767059
2015-01-01,茨城県,1490931,1490842,2981773,1197415
2015-01-01,栃木県,997942,1006475,2004417,800853
2015-01-01,群馬県,994458,1017745,2012203,815489
2015-01-01,埼玉県,3662212,3642684,7304896,3124151
2015-01-01,千葉県,3124578,3129528,6254106,2735874
2015-01-01,東京都,6565648,6731937,13297585,6784194
2015-01-01,神奈川県,4561879,4554787,9116666,4150981
2015-01-01,新潟県,1133087,1204398,2337485,880005
2015-01-01,富山県,524381,561329,1085710,408370
2015-01-01,石川県,560407,599356,1159763,470024
2015-01-01,福井県,389160,414345,803505,286201
2015-01-01,山梨県,418832,436670,855502,351845
2015-01-01,長野県,1046859,1101644,2148503,851059
2015-01-01,岐阜県,1014767,1072828,2087595,798069
2015-01-01,静岡県,1868542,1917564,3786106,1530499
2015-01-01,愛知県,3750112,3739834,7489946,3130046
2015-01-01,三重県,907884,952229,1860113,773416
2015-01-01,滋賀県,700498,720844,1421342,554109
2015-01-01,京都府,1238027,1341278,2579305,1184484
2015-01-01,大阪府,4293467,4575403,8868870,4147504
2015-01-01,兵庫県,2706852,2931486,5638338,2474489
2015-01-01,奈良県,664483,731165,1395648,580843
2015-01-01,和歌山県,475263,528467,1003730,438709
2015-01-01,鳥取県,278558,304793,583351,233650
2015-01-01,島根県,337087,369111,706198,285854
2015-01-01,岡山県,934882,1004840,1939722,823543
2015-01-01,広島県,1388164,1480995,2869159,1280555
2015-01-01,山口県,678003,753537,1431540,657547
2015-01-01,徳島県,370236,406331,776567,331059
2015-01-01,香川県,484723,520847,1005570,430089
2015-01-01,愛媛県,675440,750927,1426367,647461
2015-01-01,高知県,351939,395183,747122,352813
2015-01-01,福岡県,2431931,2688266,5120197,2321718
2015-01-01,佐賀県,401320,446104,847424,323025
2015-01-01,長崎県,663602,749553,1413155,628227
2015-01-01,熊本県,859109,959205,1818314,761778
2015-01-01,大分県,564631,626167,1190798,527744
2015-01-01,宮崎県,536561,599091,1135652,517715
2015-01-01,鹿児島県,795137,896290,1691427,804220
2015-01-01,沖縄県,716788,737235,1454023,610129
2016-01-01,北海道,2552868,2848342,5401210,2751282
2016-01-01,青森県,633903,704562,1338465,588464
2016-01-01,岩手県,619365,670105,1289470,520986
2016-01-01,宮城県,1133790,1190676,2324466,971642
2016-01-01,秋田県,491630,551385,1043015,426035
2016-01-01,山形県,543352,586208,1129560,410329
2016-01-01,福島県,956881,996818,1953699,774515
2016-01-01,茨城県,1485898,1484333,2970231,1208718
2016-01-01,栃木県,995916,1002948,1998864,809857
2016-01-01,群馬県,991916,1013404,2005320,823565
2016-01-01,埼玉県,3670697,3652716,7323413,3167510
2016-01-01,千葉県,3130062,3135837,6265899,2773070
2016-01-01,東京都,6621602,6793747,13415349,6889913
2016-01-01,神奈川県,4567791,4568360,9136151,4193331
2016-01-01,新潟県,1124655,1194780,2319435,885719
2016-01-01,富山県,522147,558013,1080160,411570
2016-01-01,石川県,559643,597399,1157042,474789
2016-01-01,福井県,387346,411874,799220,288163
2016-01-01,山梨県,416151,433633,849784,354020
2016-01-01,長野県,1042002,1095664,2137666,856348
2016-01-01,岐阜県,1009535,1066660,2076195,804061
2016-01-01,静岡県,1861080,1909539,3770619,1544095
2016-01-01,愛知県,3762016,3747620,7509636,3171435
2016-01-01,三重県,903162,946866,1850028,777756
2016-01-01,滋賀県,699781,720082,1419863,559129
2016-01-01,京都府,1235170,1339672,2574842,1193739
2016-01-01,大阪府,4288494,4577008,8865502,4186316
2016-01-01,兵庫県,2697830,2923257,5621087,2490682
2016-01-01,奈良県,660270,727548,1387818,583900
2016-01-01,和歌山県,470673,523644,994317,439637
2016-01-01,鳥取県,276664,302645,579309,234501
2016-01-01,島根県,335287,366107,701394,287437
2016-01-01,岡山県,932161,1001620,1933781,829811
2016-01-01,広島県,1386430,1476781,2863211,1290645
2016-01-01,山口県,672956,746825,1419781,658456
2016-01-01,徳島県,367282,402775,770057,332780
2016-01-01,香川県,483791,518382,1002173,433549
2016-01-01,愛媛県,670901,745096,1415997,649791
2016-01-01,高知県,348866,391193,740059,352809
2016-01-01,福岡県,2433567,2688881,5122448,2346328
2016-01-01,佐賀県,399230,443227,842457,325221
2016-01-01,長崎県,661019,743084,1404103,633084
2016-01-01,熊本県,855394,954949,1810343,767976
2016-01-01,大分県,561742,622219,1183961,530704
2016-01-01,宮崎県,533096,594982,1128078,519970
2016-01-01,鹿児島県,790125,889377,1679502,805329
2016-01-01,沖縄県,720548,740683,1461231,621790
2017-01-01,北海道,2537340,2833467,5370807,2761826
2017-01-01,青森県,627006,696855,1323861,589887
2017-01-01,岩手県,613838,663433,1277271,523065
2017-01-01,宮城県,1131759,1187679,2319438,980808
2017-01-01,秋田県,485257,543939,1029196,426020
2017-01-01,山形県,538338,580130,1118468,411919
2017-01-01,福島県,950430,988129,1938559,779244
2017-01-01,茨城県,1482072,1478386,2960458,1221978
2017-01-01,栃木県,993019,998578,1991597,817370
2017-01-01,群馬県,988955,1009320,1998275,831970
2017-01-01,埼玉県,3679223,3664584,7343807,3212080
2017-01-01,千葉県,3137814,3145788,6283602,2811702
2017-01-01,東京都,6675004,6855049,13530053,6994147
2017-01-01,神奈川県,4574910,4580479,9155389,4236072
2017-01-01,新潟県,1116170,1184753,2300923,890293
2017-01-01,富山県,520105,554600,1074705,414865
2017-01-01,石川県,558006,595621,1153627,478395
2017-01-01,福井県,385110,409323,794433,289825
2017-01-01,山梨県,413919,430798,844717,356363
2017-01-01,長野県,1036838,1089226,2126064,861074
2017-01-01,岐阜県,1004919,1061347,2066266,809888
2017-01-01,静岡県,1855174,1901691,3756865,1557733
2017-01-01,愛知県,3775270,3756961,7532231,3214669
2017-01-01,三重県,899701,942052,1841753,782840
2017-01-01,滋賀県,699932,720328,1420260,566148
2017-01-01,京都府,1232089,1337321,2569410,1202380
2017-01-01,大阪府,4283835,4577602,8861437,4223735
2017-01-01,兵庫県,2689585,2916960,5606545,2507945
2017-01-01,奈良県,656316,723865,1380181,587413
2017-01-01,和歌山県,466136,518553,984689,440150
2017-01-01,鳥取県,274794,300470,575264,235502
2017-01-01,島根県,333255,363127,696382,288790
2017-01-01,岡山県,929475,998157,1927632,835989
2017-01-01,広島県,1385401,1472074,2857475,1300322
2017-01-01,山口県,668030,740558,1408588,659804
2017-01-01,徳島県,364700,399513,764213,334117
2017-01-01,香川県,482078,515733,997811,436123
2017-01-01,愛媛県,666134,739191,1405325,651763
2017-01-01,高知県,345444,387091,732535,352694
2017-01-01,福岡県,2436091,2690298,5126389,2371459
2017-01-01,佐賀県,397243,440734,837977,328015
2017-01-01,長崎県,656314,736636,1392950,635020
2017-01-01,熊本県,850608,947541,1798149,770607
2017-01-01,大分県,558646,618245,1176891,533406
2017-01-01,宮崎県,529293,590251,1119544,521627
2017-01-01,鹿児島県,785168,882835,1668003,807169
2017-01-01,沖縄県,723531,743540,1467071,632826
2018-01-01,北海道,2522526,2817013,5339539,2772845
2018-01-01,青森県,619836,688871,1308707,591371
2018-01-01,岩手県,607653,656676,1264329,524685
2018-01-01,宮城県,1128109,1183971,2312080,989296
2018-01-01,秋田県,478874,536183,1015057,425933
2018-01-01,山形県,533428,573556,1106984,413685
2018-01-01,福島県,940942,978738,1919680,781157
2018-01-01,茨城県,1478591,1472496,2951087,1235665
2018-01-01,栃木県,991046,994692,1985738,826672
2018-01-01,群馬県,985809,1004775,1990584,841085
2018-01-01,埼玉県,3687936,3675075,7363011,3259736
2018-01-01,千葉県,3145139,3153853,6298992,2851491
2018-01-01,東京都,6720968,6916378,13637346,7096622
2018-01-01,神奈川県,4579405,4591869,9171274,4280874
2018-01-01,新潟県,1107012,1174279,2281291,895463
2018-01-01,富山県,518425,551087,1069512,418653
2018-01-01,石川県,556817,593581,1150398,482491
2018-01-01,福井県,383644,407114,790758,292518
2018-01-01,山梨県,411120,427703,838823,358393
2018-01-01,長野県,1031539,1082601,2114140,866562
2018-01-01,岐阜県,999670,1054679,2054349,816077
2018-01-01,静岡県,1848745,1894270,3743015,1571636
2018-01-01,愛知県,3785383,3766457,7551840,3257903
2018-01-01,三重県,896734,937535,1834269,789961
2018-01-01,滋賀県,699966,719669,1419635,572842
2018-01-01,京都府,1228455,1334697,2563152,1210844
2018-01-01,大阪府,4278352,4578092,8856444,4261381
2018-01-01,兵庫県,2680540,2909168,5589708,2524247
2018-01-01,奈良県,651885,719815,1371700,590664
2018-01-01,和歌山県,461537,513537,975074,440666
2018-01-01,鳥取県,272995,297829,570824,236209
2018-01-01,島根県,331378,359847,691225,290245
2018-01-01,岡山県,926557,994062,1920619,841911
2018-01-01,広島県,1381710,1467136,2848846,1308439
2018-01-01,山口県,662550,733647,1396197,660004
2018-01-01,徳島県,361622,395755,757377,334916
2018-01-01,香川県,480176,513029,993205,438842
2018-01-01,愛媛県,661140,733199,1394339,653377
2018-01-01,高知県,342201,383088,725289,352538
2018-01-01,福岡県,2439381,2691392,5130773,2398419
2018-01-01,佐賀県,395487,437785,833272,330790
2018-01-01,長崎県,649515,729488,1379003,633972
2018-01-01,熊本県,847293,941891,1789184,776133
2018-01-01,大分県,555140,614018,1169158,535794
2018-01-01,宮崎県,525934,586074,1112008,523791
2018-01-01,鹿児島県,779998,875890,1655888,807682
2018-01-01,沖縄県,725726,745810,1471536,643056
2019-01-01,北海道,2505804,2798609,5304413,2781336
2019-01-01,青森県,612406,680303,1292709,592453
2019-01-01,岩手県,601255,648887,1250142,526690
2019-01-01,宮城県,1123318,1179780,2303098,997384
2019-01-01,秋田県,472053,528170,1000223,425775
2019-01-01,山形県,528452,566931,1095383,415578
2019-01-01,福島県,932186,968867,1901053,784465
2019-01-01,茨城県,1471365,1464819,2936184,1246807
2019-01-01,栃木県,987391,988730,1976121,833629
2019-01-01,群馬県,981552,999650,1981202,848111
2019-01-01,埼玉県,3692814,3684474,7377288,3306139
2019-01-01,千葉県,3149858,3161332,6311190,2890519
2019-01-01,東京都,6764646,6976086,13740732,7198348
2019-01-01,神奈川県,4586170,4603351,9189521,4328814
2019-01-01,新潟県,1097016,1162293,2259309,899853
2019-01-01,富山県,516060,547233,1063293,422090
2019-01-01,石川県,555294,590654,1145948,486199
2019-01-01,福井県,381868,404635,786503,295136
2019-01-01,山梨県,408282,424487,832769,360354
2019-01-01,長野県,1026344,1075547,2101891,872084
2019-01-01,岐阜県,995296,1048818,2044114,824383
2019-01-01,静岡県,1841854,1884683,3726537,1585787
2019-01-01,愛知県,3792186,3773123,7565309,3300066
2019-01-01,三重県,893115,931522,1824637,795821
2019-01-01,滋賀県,700778,719302,1420080,580681
2019-01-01,京都府,1224209,1330859,2555068,1218744
2019-01-01,大阪府,4271166,4577832,8848998,4300161
2019-01-01,兵庫県,2670835,2899783,5570618,2540807
2019-01-01,奈良県,647286,715495,1362781,593688
2019-01-01,和歌山県,456598,508000,964598,440792
2019-01-01,鳥取県,270811,295241,566052,236957
2019-01-01,島根県,329526,356600,686126,291591
2019-01-01,岡山県,922984,988738,1911722,847424
2019-01-01,広島県,1377295,1461337,2838632,1315854
2019-01-01,山口県,656987,726092,1383079,660368
2019-01-01,徳島県,358588,391931,750519,335786
2019-01-01,香川県,477519,509817,987336,441030
2019-01-01,愛媛県,655577,726184,1381761,653958
2019-01-01,高知県,338823,378657,717480,352247
2019-01-01,福岡県,2440707,2690598,5131305,2424091
2019-01-01,佐賀県,393748,435033,828781,333689
2019-01-01,長崎県,643544,721847,1365391,634001
2019-01-01,熊本県,843631,936448,1780079,781507
2019-01-01,大分県,551327,608891,1160218,537715
2019-01-01,宮崎県,522376,581379,1103755,525513
2019-01-01,鹿児島県,774930,868507,1643437,808564
2019-01-01,沖縄県,728312,747866,1476178,654128
